15 15

###############
S            ##
### ######## ##
#   ##    ## ##
# #### ##### ##
#      ##### ##
# # ####   # ##
###    # # # ##
#      # #   ##
# #############
# #   #   #   #
# # # # # # # #
# # # # # # # #
#   #   #   # #
#############E#